1 13 31
###############################
#p      s* *  1 * 2 *  * * *  #
# # # #*# # #*#b# # # #*#*#*# #
#   *     ***  *  1   * 2 * * #
# # # # # #*# # #*#*# # # # #*#
#f 3456789 x **  *  *   1     #
# # # # # # #   # #*# #*# # # #
#*  *                *        #
# # # # #*# # #  *#*# # # # # #
#*    **  *       *           #
# #*# # # # #    *# # # # # # #
#           *   *  *          #
###############################
